CI -> can't import
CI-<file>-<page>

Files:
ADMINP - admin projects
ADMINR - admin reports
ADMINU - admin users
MP - main page (dashboard)
MPI - main page issues
MPNP - main page new project
MPP - main page projects
MPT - main page tasks
R - reports
US - user settings
ERROR - erro index
I - invite
PI - project issues
PII - project issues issue
PM - project members
PT - project tasks
PTT - project tasks task
PE - project edit
P - project

CF - check functions
OF - other functions
GF - get functions
AF - add functions
EF - edit functions
RF - remove functions
SC - session check time
DF - database functions
